0001000100
0000100100
0000010100
0011100000
0000010010
0010010100
1000010010
0001000000
0101111110
0000010000
