0000000000
1110000111
0000000000
0111111110
0000100000
0010010100
1000100001
0000010000
0100000010
0100000010

